First Part2:
 DB 11110011B
 DB 11111111B
 DB 11111111B
 DB 11111111B
 DB 11111100B
 DB 11111111B
 DB 00111111B
 DB 11111111B
 DB 11111111B
 DB 11111111B
 DB 11001111B
 DB 11111111B
 DB 11111100B
 DB 11111111B
 DB 00111111B
 DB 11111111B
 DB 11110011B
 DB 11111111B

 